###############
#     .   R   #
#   $         #
#             #
#     @       #
#             #
#         $   #
#   R     .   #
#           E #
###############
